{
    "0,0": {
        "0": {
            "0": [4],
            "1": [4],
            "2": [4],
            "3": [4],
            "4": [4],
            "5": [4],
            "6": [4],
            "7": [4]
        },
        "1": {
            "0": [4],
            "1": [4],
            "2": [4],
            "3": [4],
            "4": [4],
            "5": [4],
            "6": [4],
            "7": [4]
        },
        "2": {
            "0": [4],
            "1": [4],
            "2": [4],
            "3": [4],
            "4": [4],
            "5": [4],
            "6": [4],
            "7": [4]
        },
        "3": {
            "0": [4],
            "1": [4],
            "2": [4],
            "3": [4],
            "4": [4],
            "5": [4],
            "6": [4],
            "7": [4]
        },
        "4": {
            "0": [4],
            "1": [4],
            "2": [4],
            "3": [4],
            "4": [4],
            "5": [4],
            "6": [4],
            "7": [4]
        },
        "5": {
            "0": [4],
            "1": [4],
            "2": [4],
            "3": [4],
            "4": [4],
            "5": [4],
            "6": [4],
            "7": [4]
        },
        "6": {
            "0": [4],
            "1": [4],
            "2": [4],
            "3": [4],
            "4": [4],
            "5": [4],
            "6": [4],
            "7": [4]
        },
        "7": {
            "0": [4],
            "1": [4],
            "2": [4],
            "3": [4],
            "4": [4],
            "5": [4],
            "6": [4],
            "7": [4]
        }
    }
}